
 ################################################
 ################################################
 ################################################
 ################################################
 ################################################
 ################################################
 ##  #######  ###### ########       ###        ##
 ## # ##### # #####   ############ #### #########
 ## ## ### ## ####     ########## #####       ###
 ## #### #### ###       ####### ####### #########
 ## ######### ##         ####       ###        ##
 ################################################
 ################################################
 ################################################
 ################################################
 ################################################
 ################################################
 ################################################
